11111111111
10000000001
10000000001
100P0000001
10000000001
10000E00001
11111111101
10000000001
10000uu0001
100000C0001
11111111111